Map size: 30x13
0: ..............X...............
1: P..........................P..
2: ..............................
3: BBBBBBB................BBBBBBB
4: ..............................
5: ...............X..............
6: ....BBBBBBBBBBBBBBBBBBBBBB....
7: ..............................
8: ..............................
9: BBBBXBBBBB....XX....BBBBBXBBBB
10: ..............................
11: ...............X..............
12: BBBBBBBBBBBXBBX.BBXBBBBBBBBBBB
